37,52,53,53,52,52,52,52,52,38
34,47,46,48,39,91,93,36,39,34
34,35,34,43,34,44,34,45,92,34
74,74,74,74,74,74,74,74,74,74
55,65,73,73,73,73,73,65,59,57
61,73,73,61,73,65,55,73,73,63
71,68,68,68,68,68,68,68,68,69
67,84,84,84,84,84,83,84,84,67
67,84,81,81,82,84,84,83,84,67
70,81,82,81,81,81,81,82,81,72
